# ***************************************************************************
# *
# *  Copyright (C) 2004-2014, International Business Machines
# *  Corporation; Unicode, Inc.; and others.  All Rights Reserved.
# *
# ***************************************************************************
# File: la_la_FONIPA.txt
# Generated from CLDR 
#

::Lower;
::NFC;

$vowel = [aáàăāeéèĕēiíìĭīoóòŏōuúùŭūæœ];
$end_of_word = [$ ];

ae → aj;
av → aw;
æ → aj; # 19th century English orthography
ā → aː;
[aáàă] → a;
b → b;
ch → kʰ; # Greek loanwoards
c → k;
d → d;
ev → ew;
ē → eː;
[eéèĕ] → ɛ;
f → f;
{g} n → ŋ; # eg. agnus
g → ɡ;
h → h;
ī → iː;
{[iíìĭ]} $vowel → j; # eg. cuius
[iíìĭ] → ɪ;
k → k;
l → l;
m → m;
{n} [bpfm] → m; # eg. infirmus
{n} [gckq] → ŋ; # eg. quinque
n → n;
œ → oj; # 19th century English orthography
oe → oj;
ō → oː;
[oóòŏ] → ɔ;
ph → pʰ; # Greek loanwords
p → p;
qu → kʷ;
qv → kʷ;
rh → rʰ; # Greek loanwords
r → r;
s → s;
th → tʰ; # Greek loanwords
t → t;
ū → uː;
[uúùŭ] → ʊ;
{v} $vowel → w;
v → u;
xs → ks; # Old Latin spelling
x → ks;
y → y; # Greek loanwords
z → d\u0361z; # eg. zerum

::Null;


bb → bː;
dd → dː;
ɡɡ → ɡː;
hh → hː;
kk → kː;
ll → lː;
mm → mː;
nn → nː;
pp → pː;
rr → rː;
ss → sː;
tt → tː;

{l} [^aeɛiouː] → ɫ;

::NFC;
